00010001000
01111011100
00000000000
00000000000
00011111100
