0100010000010100100010001010100100010
0100010001010100000010001010100100010
0100001000010100100010001000000100010
0000000001010000100010001010100100010
1110100110000011000000111110101111000
0100010001010100100010001000100100010
0100010000010000100010001010100100010
0100000000010100100010000010100000010
0100010001010100000000001000100100010
0100010001010100100010001010000000000
0100010000010100100010001010100100010
0100010001010100000010001010100100010
0100001000010100100010001000000100010
0000000001010000100010001010100100010
1110100110000011000000111110101111000
0100010001010100100010001000100100010
0100010000010000100010001010100100010
0100000000010100100010000010100000010
0100010001010100000000001000100100010
0100010001010100100010001010000000000
0100010001010100100010001000100100010
0100010000010000100010001010100100010
0100000000010100100010000010100000010
0100010001010100000000001000100100010
0100010001010100100010001010000000000
